S..........F#.#D....
..A.B.C...E.K.#.....
..F#.#D...........G.
..E.K.#..A.B.C......
..........F#.#D.....
..A.B.C...E.K.#.....
..F#.#D.............
..E.K.#..A.B.C......
..........F#.#D.....
..A.B.C...E.K.#.....
