...S......
..A.B.C...
..F#.#D...
..E.K.G...
.........#

