S..A.B#...
.#..#.K...
..C..D....
.#E.F.....
....G.....
......